########################################################################
#..................#...................................................#
#..................#.............##############################........#
#........##........#########.....##############################........#
#........##........#.............##############################........#
#..................#...................................................#
#..................#...................................................#
#..................#...#...####################################...#....#
#..................#...#...#......................................#....#
#..................#...#...#......................................#....#
#......................#...#......................................#....#
#......................#...#...#...##############...###############....#
#..................#####...#...#.........................###......#....#
#........##........#...........#.......###...###.........###......#....#
#........##........#...........#.......###...###.........###......#....#
#..................#...........#.......###...###..................#....#
#..................#.......#...################################...#....#
#..................#.......#...#.......................................#
#..................#.......#...#.......................................#
#..................#.......#...#.......................................#
########################################################################

[
    {
       "classname": "Player",
        "x_coord": 1,
        "y_coord": 1 
    },
    {
        "classname": "ItemPickup",
        "x_coord": 3,
        "y_coord": 3,
        "args": [["This is totally an item", "And this"]] 
    }
]
