####################
#..................#
#..................#
#........##........#
#........##........#
#..................#
#..................#
#..................#
#..................#
#..................#
#..................#
#..................#
#..................#
#........##........#
#........##........#
#..................#
#..................#
#..................#
#..................#
#..................#
####################
